XXXXXXXXXXXXXXXXXXXXXXXXXXXXXXXXXXXXXXXXXXXXXXXXXXXXXXXXXXXXXXXXXXXXXXXXXXXXXXXXXXXXXXXX
X                                                                                      X
X XXXXXXXXXXXXXXXXXXXXXXXXXXXXXXXXXXXXXXXX    XXXXXXXXXXXXXXXXXXXXXXXXXXXXXXXXXXXXXXXX X
X X                                      X    X                                      X X
X X                                      X    X                                      X X
X X  .  .  .  .  .  .  .  .  .  .  .  .  X    X  .  .  .  .  .  .  .  .  .  .  .  .  X X
X X                                      X    X                                      X X
X X                                      X    X                                      X X
X X  .  XXXXXXXXX  .  XXXXXXXXXXXXX   .  X    X  .   XXXXXXXXXXXXX  .  XXXXXXXXX  .  X X
X X     X       X     X           X      X    X      X           X     X       X     X X
X X     X       X     X           X      X    X      X           X     X       X     X X
X X  .  X       X  .  X           X   .  X    X  .   X           X  .  X       X  .  X X
X X     X       X     X           X      X    X      X           X     X       X     X X
X X     X       X     X           X      X    X      X           X     X       X     X X
X X  .  XXXXXXXXX  .  XXXXXXXXXXXXX   .  XXXXXX  .   XXXXXXXXXXXXX  .  XXXXXXXXX  .  X X
X X                                                                                  X X
X X                                                                                  X X
X X  .  .  .  .  .  .  .  .  .  .  .  .  .    .  .  .  .  .  .  .  .  .  .  .  .  .  X X
X X                                                                                  X X
X X                                                                                  X X
X X  .  XXXXXXXXX  .  XXXX  .  XXXXXXXXXXXXXXXXXXXXXXXXXX  .  XXXX  .  XXXXXXXXX  .  X X
X X     X       X     X  X     X                        X     X  X     X       X     X X
X X     X       X     X  X     X                        X     X  X     X       X     X X
X X  .  XXXXXXXXX  .  X  X  .  XXXXXXXXXXX    XXXXXXXXXXX  .  X  X  .  XXXXXXXXX  .  X X
X X                   X  X               X    X               X  X                   X X
X X                   X  X               X    X               X  X                   X X
X X  .  .  .  .  .  . X  X  .  .  .  .   X    X   .  .  .  .  X  X .  .  .  .  .  .  X X
X X                   X  X               X    X               X  X                   X X
X X                   X  X               X    X               X  X                   X X
X XXXXXXXXXXXXXXXX .  X  XXXXXXXXXX      X    X      XXXXXXXXXX  X  . XXXXXXXXXXXXXXXX X
X                X    X           X      X    X      X           X    X                X
XXXXXXXXXXXXXXXX X    X           X      X    X      X           X    X XXXXXXXXXXXXXXXX
               X X .  X  XXXXXXXXXX      XXXXXX      XXXXXXXXXX  X  . X X
               X X    X  X                                    X  X    X X    
               X X    X  X                                    X  X    X X
               X X .  X  X                                    X  X  . X X                   
               X X    X  X                                    X  X    X X    
               X X    X  X                                    X  X    X X
               X X .  X  X     XXXXXXXXXX      XXXXXXXXXX     X  X  . X X
               X X    X  X     X                        X     X  X    X X
XXXXXXXXXXXXXXXX X    X  X     X XXXXXXXX      XXXXXXXX X     X  X    X XXXXXXXXXXXXXXXX
                 X .  X  X     X X                    X X     X  X  . X 
XXXXXXXXXXXXXXXXXX    XXXX     X X                    X X     XXXX    XXXXXXXXXXXXXXXXXX
                               X X                    X X                               
                   .           X X                    X X           .                    
                               X X                    X X                               
                               X X                    X X                               
XXXXXXXXXXXXXXXXX  .  XXXX     X X                    X X     XXXX  . XXXXXXXXXXXXXXXXXX
                X     X  X     X XXXXXXXXXXXXXXXXXXXXXX X     X  X    X 
XXXXXXXXXXXXXXX X     X  X     X                        X     X  X    X XXXXXXXXXXXXXXXX
              X X  .  X  X     XXXXXXXXXXXXXXXXXXXXXXXXXX     X  X  . X X               
              X X     X  X                                    X  X    X X               
              X X     X  X                                    X  X    X X
              X X  .  X  X                                    X  X  . X X
              X X     X  X                                    X  X    X X               
              X X     X  X                                    X  X    X X               
              X X  .  X  X     XXXXXXXXXXXXXXXXXXXXXXXXXX     X  X  . X X
XXXXXXXXXXXXXXX X     X  X     X                        X     X  X    X XXXXXXXXXXXXXXXX
X               X     X  X     X                        X     X  X    X                X
X XXXXXXXXXXXXXXX  .  XXXX     XXXXXXXXXX    XXXXXXXXXXXX     XXXX  . XXXXXXXXXXXXXXXX X
X X                                     X    X                                       X X
X X                                     X    X                                       X X
X X  .  .  .  .  .  .  .  .  .  .  .    X    X   .  .  .  .  .  .  .  .  .  .  .  .  X X
X X                                     X    X                                       X X
X X                                     X    X                                       X X
X X  .  XXXXXXXXX  .  XXXXXXXXXXX  .    X    X   .  XXXXXXXXXXXXXX  .  XXXXXXXXXX .  X X
X X     X       X     X         X       X    X      X            X     X        X    X X
X X     X       X     X         X       X    X      X            X     X        X    X X
X X  .  XXXX    X  .  XXXXXXXXXXX  .    XXXXXX   .  XXXXXXXXXXXXXX  .  X    XXXXX .  X X
X X        X    X                                                      X    X        X X
X X        X    X                                                      X    X        X X
X X  .  .  X    X  .  .  .  .  .   .  .  .  .    .  .  .  .  .  .   .  X    X  .  .  X X
X X        X    X                                                      X    X        X X
X X        X    X                                                      X    X        X X 
X XXXX  .  X    X  .  XXXX  .  XXXXXXXXXXXXXXXXXXXXXXXXXX  .  XXXX  .  X    X  .  XXXX X
X    X     X    X     X  X     X                        X     X  X     X    X     X    X
X    X     X    X     X  X     X                        X     X  X     X    X     X    X
X XXXX  .  XXXXXX  .  X  X  .  XXXXXXXXXX      XXXXXXXXXX  .  X  X  .  XXXXXX  .  XXXX X
X X                   X  X              X      X              X  X                   X X
X X                   X  X              X      X              X  X                   X X
X X  .  .  .  .    .  X  X  .  .  .  .  X      X  .  .  .  .  X  X  .    .  .  .  .  X X
X X                   X  X              X      X              X  X                   X X
X X                   X  X              X      X              X  X                   X X
X X  .  XXXXXXXXXXXXXXX  XXXXXXXXXX  .  X      X  .  XXXXXXXXXX  XXXXXXXXXXXXXXX  .  X X
X X     X                         X     X      X     X                         X     X X
X X     X                         X     X      X     X                         X     X X
X X  .  XXXXXXXXXXXXXXXXXXXXXXXXXXX  .  XXXXXXXX  .  XXXXXXXXXXXXXXXXXXXXXXXXXXX  .  X X
X X                                                                                  X X
X X                                                                                  X X
X X  .  .  .  .  .  .  .  .  .  .  .  .  .    .  .  .  .  .  .  .  .  .  .  .  .  .  X X
X X                                                                                  X X
X X                                                                                  X X
X XXXXXXXXXXXXXXXXXXXXXXXXXXXXXXXXXXXXXXXXXXXXXXXXXXXXXXXXXXXXXXXXXXXXXXXXXXXXXXXXXXXX X
X                                                                                      X
XXXXXXXXXXXXXXXXXXXXXXXXXXXXXXXXXXXXXXXXXXXXXXXXXXXXXXXXXXXXXXXXXXXXXXXXXXXXXXXXXXXXXXXX

 
